J J J . G . . . .
. . . . G T T R .
. . . . G . . R .
A A A L . K . R 0
. . . L . K . . .
. Z Z Z . K . P P
. . . S S . . . .
. I I . . F F . Y
. . . O O . . . Y
