. A G F F
. A G R .
. A . R .
. . . I .
. . . I .
. . T . R
. 0 T . R
