. . A F F
. . A R .
H H A R .
. G G I .
B . . I B
. . T T R
U U 0 . R
