. . . . . . . . .
. . . . . . . R .
. . . . . C . R .
A A A . . C . R 0
. . . . . . . . .
. . . . . . . . .
. . . . . . . . .
. . . . . . . . .
. . . . . . . . .
