J J J . G . . . .
. . . L G T T . .
. . . L G . C . .
A A A L . K C . 0
. . . B . K C . .
. Z Z Z . K . P P
. . . . B S S Y .
. I I . . F F Y .
. . . O O . . . .
