. A G F F
. A G R .
. A . R .
. . . I B
. . . I B
. . J J R
. 0 T T R
