C A G F F
C A G . D
. A R R D
. P P I .
. . . I .
Y . T . .
Y 0 T Z Z
