J J J . G . . . .
. . . . G T T . .
. . . . G . . . .
A A A L . K B B 0
. . . L . K . . .
. Z Z Z . K . P P
. . . S S . . . .
. I I . . F F . Y
. . . O O . . . Y
