. A G F F
. A G . .
. A R R .
. P P I .
. . . I .
Y . T . .
Y 0 T Z Z
