. . . . . B . B .
. . B . . . . . .
. . . . B Y Y Y .
A A A L . K . . 0
. . . L . K . . .
. Z Z Z . K . . B
. . B S S K . . .
. . . . . K . B .
. . B . O O B . B