. . . . B B
. . . . . .
C C . . D .
A A . . D 0
. . E E . .
. . . . . .
