A A A . M . 0
C C . . M D D
. . E E F F .
G G . H H I I
. J J . . K K