. A G F F
. A G R .
. A . R .
. M M I .
. B B I .
. . T . R
. 0 T . R
