J J J . G . . . .
. . . . G . T T .
. . . . G . R R .
A A A L . . . . 0
. . . L . K K . .
. Z Z . . H H . .
. . . S S . . . .
. I I . . F F . Y
. . . O O . P P Y
