. . G . A
. . G R A
. J H R A
. J H I I
U Y Y . .
U . . K K
L L . . 0