J J J B G . . . .
. . . . G . T T .
. . . . G . R R .
A A A L . . . . 0
. . . L . K K . .
. Z Z . . H H . .
. . . S S . . . .
. I I . B F F . Y
. . . O O . P P Y
