. A G F F
B A G . .
B A R R .
. G G I .
. . . I .
R . T . .
R 0 T R R