J J J . G . . . .
. . . . G T T . .
. . . . G . . R .
A A A L . K E R 0
. . . L . K E H H
. Z Z . . . P P .
. . . S S . . . .
. I I . . F F . Y
. . . O O . . . Y