J J J B G . . . .
. . . . G T T . .
. . . . G . R R .
A A A L . K E . 0
. . . L B K E H H
. Z Z . . . . P P
. . . S S . . . .
. I I . . F F B Y
. . . O O . . . Y
