A  A  A  .  B  .  0
C  C  .  .  B  D  D
.  .  E  E  F  F  .
G  G  .  H  H  I  I
.  J  J  .  .  K  K