. A G F F
. A G R .
. A . R .
. . . I .
. . . I .
. . T . X
. 0 T . X
