. . . Y Y Y . A . . . . F F . 
. B . . . . . A . N N . B . . 
. V . . F . . A . . . . . . . 
. V . B F . C C C C C . D . M 
. . . . F . . . . . . . D . M 
B . . U U U B . . . . . D . M 
Q Q . . P P . . . . . . . . . 
. . . . . J I I I . B . B . . 
. R . . . J . . H H H . . B . 
. R . . . . . . . . . . . . . 
S S S . . B . . . G . B . . . 
. . . . T . . . . G . . . . . 
L . . B T . E E E G . . K K K 
L . . . . . . . . G . O . . . 
L . Z Z . . . 0 . X X O . . . 